#####################################################################  
||.. ...................                 .................  ......  || 
||.. %%%%%%%%%%%%%%%%        ...     %%%%%%%%%%%%%%  |%|..   %%%%   || 
||..        |%|   |%|     |%|        |%|        |%|  |%|..    |%|   || 
||..        |%|   |%|     |%|        |%|        |%|  |%|..    |%|   || 
||..        %%%%%%%%  . . |%|        %%%%%%%%%%%%%%     ..   %%%%.  || 
||..        |%|       . . |%|       ............... |%| ..       .  || 
||..        %%%%%%%%%%. . |%|...    %%%%%%%%%%%%    |%| ..   %%%%.  || 
||..               |%|.             |%|......       |%| ..    |%|.  || 
||..     ......... |%|.             |%|     .|%|        ..    |%|.  || 
||..|%|  |%|%%%|%|.|%|. |%|            .    .|%|        ..|%| |%|.  || 
||..|%|  |%|   |%|..    %%%%%%%%%%%%%  ......|%|         .|%|.      || 
||..|%|  |%|   |%|..           ...|%|     %%%%%%        . |%|.      || 
||..|%|            .           ...|%|               |%| ..|%|.      || 
||..|%|  %%%%%%%%%%%%%%        ...|%|%%%%%%%%%%     |%| ..|%|%%%%%  || 
||.....                               ...........   |%| ..........  || 
||   ....                 .......          ......          .......  || 
||..|%|  |%|   |%|..    %%%%%%%%%%%%%  ......|%|    |%| ..|%|.      || 
||..|%|  |%|   |%|..           ...|%|     %%%%%%    |%| ..|%|.      || 
||..|%|            .           ...|%|               |%| ..|%|.      || 
||..|%|  %%%%%%%%%%%%%%        ...|%|%%%%%%%%%%     |%| ..|%|%%%%%  || 
||....                                ...........   |%| ..........  || 
||  .............................................          .......  || 
#####################################################################  
